1111111111111111111111111111111111111111
1 E1EE S     1 M       1         1EEEEE1
1 11111 1111 1 1EEEEEEE1 1EEEEEEE      1
1 P    E1EE  1 1EEEEEEE1 111111111  EEE1
1 11111 1 1111 1111111 1 1EEE  S    EEE1
1 E1EE  1      1EEEE  M  1EEE11111111111
1111111111111111111111111111 1EEEEEEEEE1
1ES  E  E M  E   EEEE1 S     11111111  1
1  11111111111111 1111 1111111EEEEM    1
11 1 S   M    EE1 1EE1   1EE1EE1111111 1
1E 1 111111 1 111 1E S 1   E1 11EEEEEES1
1 11 1EEEEEE1  E1 111111 1111 1EE1111111
1 M  1111111111 1 S  E  E   M 1    EEEE1
1111111EEEEEM 1 111111111111111111111EE1
1EEEEE1EEEEE1 S  E M    1 M 1EEEEEEE1EE1
1EEEEE11111111111111111 1 1  EEEEEEE1111
1EEEEEM  S   M  E     1 1 11111111111EE1
1111111111 1111111111 S     M1EEEEEEEEE1
1EEEEE  S  1  EEEEEE11111111     EEEEEE1
111111111111 11111111EE 1E 1 11111111111
1   SEEEEE   E     E S  E    M EEEEEEEE1
1 11111111111111111111111111111111111111
1EE   M  1E 1ESE1E1  SEEEEEEEM 1E1 EEEE1
11111111 1  EE1 EE1 1111111111 1 S  1 E1
1EEE   S  E 1111111  EEEEEEEE1 1 EE1  E1
1EEE111111  1EE   1111111111 1 1  1EE1E1
1EEE1   M   1   1 S      M   1EEE1EE1EE1
1EEE111111111   111111111  1111111111111
1EEE     M     S  EEEEEE1  MEEEEEEEEEEE1
1111111111111111111111111111111111111111